"filename", "language", "Dart", "comment", "blank", "total"
"d:\workshop\Flutter\FlutterStudy\flutter_example\lib\chat-app\main_page.dart", "Dart", 312, 1, 25, 338
"d:\workshop\Flutter\FlutterStudy\flutter_example\lib\chat-app\models\api_model.dart", "Dart", 51, 0, 6, 57
"d:\workshop\Flutter\FlutterStudy\flutter_example\lib\chat-app\models\character_model.dart", "Dart", 173, 4, 25, 202
"d:\workshop\Flutter\FlutterStudy\flutter_example\lib\chat-app\models\chat_model.dart", "Dart", 104, 0, 11, 115
"d:\workshop\Flutter\FlutterStudy\flutter_example\lib\chat-app\models\comment_model.dart", "Dart", 42, 8, 8, 58
"d:\workshop\Flutter\FlutterStudy\flutter_example\lib\chat-app\models\daos\message_dao.dart", "Dart", 81, 0, 9, 90
"d:\workshop\Flutter\FlutterStudy\flutter_example\lib\chat-app\models\message_model.dart", "Dart", 62, 1, 11, 74
"d:\workshop\Flutter\FlutterStudy\flutter_example\lib\chat-app\models\moment_model.dart", "Dart", 68, 8, 16, 92
"d:\workshop\Flutter\FlutterStudy\flutter_example\lib\chat-app\models\prompt_model.dart", "Dart", 120, 0, 17, 137
"d:\workshop\Flutter\FlutterStudy\flutter_example\lib\chat-app\pages\character\character_selector.dart", "Dart", 125, 0, 11, 136
"d:\workshop\Flutter\FlutterStudy\flutter_example\lib\chat-app\pages\character\contacts_page.dart", "Dart", 134, 6, 11, 151
"d:\workshop\Flutter\FlutterStudy\flutter_example\lib\chat-app\pages\character\edit_character_page.dart", "Dart", 729, 5, 36, 770
"d:\workshop\Flutter\FlutterStudy\flutter_example\lib\chat-app\pages\character\personal_page.dart", "Dart", 297, 14, 35, 346
"d:\workshop\Flutter\FlutterStudy\flutter_example\lib\chat-app\pages\chat\chat_detail_page.dart", "Dart", 788, 46, 47, 881
"d:\workshop\Flutter\FlutterStudy\flutter_example\lib\chat-app\pages\chat\chat_page.dart", "Dart", 96, 0, 8, 104
"d:\workshop\Flutter\FlutterStudy\flutter_example\lib\chat-app\pages\chat\edit_chat.dart", "Dart", 454, 33, 27, 514
"d:\workshop\Flutter\FlutterStudy\flutter_example\lib\chat-app\pages\chat\new_chat.dart", "Dart", 197, 0, 16, 213
"d:\workshop\Flutter\FlutterStudy\flutter_example\lib\chat-app\pages\chat\prompt_preview_page.dart", "Dart", 109, 1, 10, 120
"d:\workshop\Flutter\FlutterStudy\flutter_example\lib\chat-app\pages\moment\discover_page.dart", "Dart", 94, 7, 9, 110
"d:\workshop\Flutter\FlutterStudy\flutter_example\lib\chat-app\pages\moment\edit_moment.dart", "Dart", 217, 0, 17, 234
"d:\workshop\Flutter\FlutterStudy\flutter_example\lib\chat-app\pages\moment\moment_detail_page.dart", "Dart", 453, 9, 18, 480
"d:\workshop\Flutter\FlutterStudy\flutter_example\lib\chat-app\pages\moment\moment_waterfall_page.dart", "Dart", 39, 0, 3, 42
"d:\workshop\Flutter\FlutterStudy\flutter_example\lib\chat-app\pages\prompt\api_edit.dart", "Dart", 174, 0, 15, 189
"d:\workshop\Flutter\FlutterStudy\flutter_example\lib\chat-app\pages\prompt\api_manager.dart", "Dart", 39, 0, 3, 42
"d:\workshop\Flutter\FlutterStudy\flutter_example\lib\chat-app\pages\prompt\edit_prompt.dart", "Dart", 190, 0, 20, 210
"d:\workshop\Flutter\FlutterStudy\flutter_example\lib\chat-app\pages\prompt\prompt_manager.dart", "Dart", 210, 13, 13, 236
"d:\workshop\Flutter\FlutterStudy\flutter_example\lib\chat-app\providers\character_controller.dart", "Dart", 85, 9, 21, 115
"d:\workshop\Flutter\FlutterStudy\flutter_example\lib\chat-app\providers\chat_controller.dart", "Dart", 300, 19, 47, 366
"d:\workshop\Flutter\FlutterStudy\flutter_example\lib\chat-app\providers\moment_controller.dart", "Dart", 105, 19, 20, 144
"d:\workshop\Flutter\FlutterStudy\flutter_example\lib\chat-app\providers\prompt_controller.dart", "Dart", 96, 10, 20, 126
"d:\workshop\Flutter\FlutterStudy\flutter_example\lib\chat-app\providers\setting_controller.dart", "Dart", 72, 8, 14, 94
"d:\workshop\Flutter\FlutterStudy\flutter_example\lib\chat-app\theme\app_theme.dart", "Dart", 16, 14, 3, 33
"d:\workshop\Flutter\FlutterStudy\flutter_example\lib\chat-app\utils\AIHandler.dart", "Dart", 100, 3, 20, 123
"d:\workshop\Flutter\FlutterStudy\flutter_example\lib\chat-app\utils\RequestOptions.dart", "Dart", 65, 0, 5, 70
"d:\workshop\Flutter\FlutterStudy\flutter_example\lib\chat-app\utils\backup_helper.dart", "Dart", 56, 0, 9, 65
"d:\workshop\Flutter\FlutterStudy\flutter_example\lib\chat-app\utils\image_helper.dart", "Dart", 15, 0, 3, 18
"d:\workshop\Flutter\FlutterStudy\flutter_example\lib\chat-app\utils\webdav_util.dart", "Dart", 105, 17, 12, 134
"d:\workshop\Flutter\FlutterStudy\flutter_example\lib\chat-app\widgets\bubble_animation.dart", "Dart", 28, 0, 7, 35
"d:\workshop\Flutter\FlutterStudy\flutter_example\lib\chat-app\widgets\character\edit_relationship.dart", "Dart", 147, 0, 15, 162
"d:\workshop\Flutter\FlutterStudy\flutter_example\lib\chat-app\widgets\chat\character_wheel.dart", "Dart", 98, 4, 6, 108
"d:\workshop\Flutter\FlutterStudy\flutter_example\lib\chat-app\widgets\chat\chat_list_item.dart", "Dart", 139, 2, 10, 151
"d:\workshop\Flutter\FlutterStudy\flutter_example\lib\chat-app\widgets\moment_card.dart", "Dart", 176, 24, 12, 212
"d:\workshop\Flutter\FlutterStudy\flutter_example\lib\chat-app\widgets\moment_card_waterflow.dart", "Dart", 126, 0, 11, 137
"d:\workshop\Flutter\FlutterStudy\flutter_example\lib\chat-app\widgets\prompt\prompt_editor.dart", "Dart", 184, 0, 13, 197
"d:\workshop\Flutter\FlutterStudy\flutter_example\lib\chat-app\widgets\prompt\promptref_editor.dart", "Dart", 141, 2, 17, 160
"d:\workshop\Flutter\FlutterStudy\flutter_example\lib\chat-app\widgets\prompt\request_options_editor.dart", "Dart", 187, 0, 13, 200
"d:\workshop\Flutter\FlutterStudy\flutter_example\lib\chat-app\widgets\sizeAnimated.dart", "Dart", 71, 0, 10, 81
"d:\workshop\Flutter\FlutterStudy\flutter_example\lib\chat-app\widgets\stack_avatar.dart", "Dart", 76, 0, 7, 83
"Total", "-", 7746, 287, 722, 8755